ADMIN	AE D M IH N
CHROME	K R OW M
CLOSE	K L OW S
CLOSE(2)	K L OW Z
CONTROL	K AH N T R OW L
EX	EH K S
FACEBOOK	F EY S B UH K
FILE	F AY L
GMAIL	G M EY L
MAIL	M EY L
MANAGER	M AE N AH JH ER
MANAGER(2)	M AE N IH JH ER
NEW	N UW
NEW(2)	N Y UW
OLS	AA L Z
OPEN	OW P AH N
PAD	P AE D
PAINT	P EY N T
PDF	P IY D IY F
PLUS	P L AH S
PROJECT	P R AA JH EH K T
SERVICE	S ER V AH S
SERVICE(2)	S ER V IH S
SKYPE	S K AY P
TAB	T AE B
TASK	T AE S K
TN	T IY N
VM	V IY M
WORD	W ER D
YOUTUBE	Y UW T UW B
